|                                                         |
|                                                         |
|                  +                                      |
|                                                         |
|                                                         |
|                                                         |
|                                                         |
|                                                         |
|                                                         |
|                                                         |
|                                                         |
|                                                         |
|                                                         |
|                                                         |
|                                                         |
|               🧱🧱🧱🧱🧱🧱                                    |
|                                                         |
|                                                         |
|            🧱🧱🧱🧱🧱🧱 🧱🧱🧱🧱🧱🧱                                |
|                                                         |
|                                                         |
|         🧱🧱🧱🧱🧱🧱 🧱🧱🧱🧱🧱🧱 🧱🧱🧱🧱🧱🧱                            |
|                                                         |
|                                                         |
|             🧱   🧱                                       |
|             🧱   🧱                                       |
|             🧱   🧱                                       |
|          🧱🧱🧱🧱   🧱🧱🧱                                     |
|          🧱        🧱                                     |
|          🧱        🧱                                     |
|          🧱        🧱                                     |
|          🧱        🧱                                     |
|          🧱        🧱                                     |
|          🧱        🧱                                     |
|          🧱🧱🧱🧱🧱🧱🧱🧱🧱🧱                                     |
|                                                         |
|                                                         |
|                                                         |
|                                                         |
|                                                         |
|     🧱                                                   |
|     🧱   🧱 🧱                                             |
|     🧱   🧱 🧱                                             |
|     🧱   🧱 🧱                                             |
|     🧱 🧱 🧱 🧱                                             |
|     🧱 🧱 🧱 🧱                                             |
|     🧱 🧱 🧱 🧱                                             |
|     🧱🧱🧱🧱🧱🧱🧱                                             |
|                                                         |
|                                                         |
|          🧱🧱🧱🧱🧱                                          |
|                                                         |
|       🧱🧱🧱🧱🧱 🧱🧱🧱🧱🧱                                       |
|                                                         |
|    🧱🧱🧱🧱🧱 🧱🧱🧱🧱🧱 🧱🧱🧱🧱🧱                                    |
|                                                         |
| 🧱🧱🧱🧱🧱 🧱🧱🧱🧱🧱 🧱🧱🧱🧱🧱 🧱🧱🧱🧱🧱                                 |
|                                                         |
|                                                         |
|                       🧱 🧱                               |
|                       🧱 🧱                               |
|                🧱🧱🧱🧱🧱🧱🧱🧱 🧱🧱🧱                             |
|                🧱          🧱                             |
|                🧱          🧱                             |
|                🧱          🧱                             |
|                🧱          🧱                             |
|                🧱          🧱                             |
|                🧱          🧱                             |
|                🧱🧱🧱🧱🧱🧱🧱🧱🧱🧱🧱🧱                             |
|                                                         |
|                                                         |
|                       🧱     🧱                           |
|                       🧱🧱🧱🧱🧱🧱🧱                           |
|                                                         |
|                                                         |
|                            🧱🧱🧱🧱🧱                        |
|                                                         |
|                         🧱🧱🧱🧱🧱 🧱🧱🧱🧱🧱                     |
|                                                         |
|                      🧱🧱🧱🧱🧱 🧱🧱🧱🧱🧱 🧱🧱🧱🧱🧱                  |
|                                                         |
|                                                         |
|                                                         |
|                                      🧱                  |
|                                    🧱 🧱     🧱 🧱          |
|                                    🧱 🧱     🧱 🧱          |
|                                    🧱 🧱   🧱 🧱 🧱          |
|                                    🧱 🧱   🧱 🧱 🧱          |
|                                🧱   🧱 🧱 🧱 🧱 🧱 🧱          |
|                              🧱 🧱 🧱 🧱 🧱 🧱 🧱 🧱 🧱          |
|                              🧱 🧱 🧱 🧱 🧱 🧱 🧱 🧱 🧱          |
|                              🧱 🧱 🧱 🧱 🧱 🧱 🧱 🧱 🧱          |
|                              🧱🧱🧱🧱🧱🧱🧱🧱🧱🧱🧱🧱🧱🧱🧱🧱🧱          |
|                                                         |
|                                                         |
|                          🧱                              |
|                          🧱                              |
|                          🧱                              |
|                          🧱   🧱                          |
|                          🧱   🧱                          |
|                          🧱   🧱                          |
|                          🧱   🧱                          |
|                          🧱   🧱                          |
|                          🧱 🧱 🧱                          |
|                          🧱 🧱 🧱                          |
|                          🧱🧱🧱🧱🧱                          |
|                                                         |
|                                                         |
|                              🧱   🧱                      |
|                              🧱   🧱                      |
|                       🧱🧱🧱🧱🧱🧱🧱🧱   🧱🧱🧱                    |
|                       🧱            🧱                    |
|                       🧱            🧱                    |
|                       🧱            🧱                    |
|                       🧱            🧱                    |
|                       🧱            🧱                    |
|                       🧱🧱🧱🧱🧱🧱🧱🧱🧱🧱🧱🧱🧱🧱                    |
|                                                         |
|                                                         |
|                                  🧱🧱🧱🧱🧱🧱                 |
|                                                         |
|                                                         |
|                               🧱🧱🧱🧱🧱🧱 🧱🧱🧱🧱🧱🧱             |
|                                                         |
|                                                         |
|                            🧱🧱🧱🧱🧱🧱 🧱🧱🧱🧱🧱🧱 🧱🧱🧱🧱🧱🧱         |
|                                                         |
|                                                         |
|                         🧱🧱🧱🧱🧱🧱 🧱🧱🧱🧱🧱🧱 🧱🧱🧱🧱🧱🧱 🧱🧱🧱🧱🧱🧱     |
|                                                         |
|                                                         |
|                      🧱🧱🧱🧱🧱🧱 🧱🧱🧱🧱🧱🧱 🧱🧱🧱🧱🧱🧱 🧱🧱🧱🧱🧱🧱 🧱🧱🧱🧱🧱🧱 |
|                                                         |
|                                                         |
|                                                         |
|                                                         |
|                                   🧱                     |
|                        🧱🧱🧱🧱🧱🧱🧱🧱🧱🧱🧱🧱                     |
|                                                         |
|                                                         |
|                    🧱    🧱                               |
|                    🧱    🧱                               |
|                    🧱    🧱                               |
|                🧱🧱🧱🧱🧱    🧱🧱🧱🧱🧱🧱🧱🧱                        |
|                🧱               🧱                        |
|                🧱               🧱                        |
|                🧱               🧱                        |
|                🧱🧱🧱🧱🧱🧱🧱🧱🧱🧱🧱🧱🧱🧱🧱🧱🧱                        |
|                                                         |
|                                                         |
|                                          🧱              |
|                                🧱🧱🧱🧱🧱🧱🧱🧱🧱🧱🧱              |
|                                                         |
|                       🧱            🧱                    |
|                       🧱🧱🧱🧱🧱🧱🧱🧱🧱🧱🧱🧱🧱🧱                    |
|                                                         |
|                                                         |
|                                              🧱          |
|                                              🧱          |
|                                              🧱          |
|                                              🧱          |
|                                          🧱 🧱 🧱          |
|                                      🧱   🧱 🧱 🧱          |
|                                      🧱   🧱 🧱 🧱          |
|                                      🧱   🧱 🧱 🧱          |
|                                      🧱 🧱 🧱 🧱 🧱          |
|                                      🧱 🧱 🧱 🧱 🧱          |
|                                      🧱🧱🧱🧱🧱🧱🧱🧱🧱          |
|                                                         |
|_________________________________________________________|